EMP = "countries/The Empire.txt"
ERI = "countries/Eriadu Authority.txt"
SID = "countries/Sidious.txt"
IBC = "countries/Intergalactic Banking Clan.txt"
SFS = "countries/Sienar Fleet Systems.txt"
TAG = "countries/TaggeCo.txt"
FED = "countries/Trade Federation Remnant.txt"
MIT = "countries/House Mitth.txt"
RIN = "countries/Rintonne.txt"
REB = "countries/The Rebellion.txt"
BEA = "countries/Besadii.txt"
SHA = "countries/Shadow Collective.txt"
INR = "countries/House Inrokini.txt"
BLA = "countries/Black Sun.txt"
ABR = "countries/Abregado-rae.txt"
ZYG = "countries/Zygerria.txt"
JHT = "countries/Jabba.txt"
ZAN = "countries/Zann Consortium.txt"
PYK = "countries/Pyke Syndicate.txt"
HAP = "countries/Hapes Consortium.txt"
FTU = "countries/Federated Teradoc Union.txt"
BAK = "countries/Bakura.txt"
BES = "countries/Bespin.txt"
CHA = "countries/Chandrila.txt"
MAL = "countries/Malastare.txt"
BOT = "countries/Bothawui.txt"
ZER = "countries/Zero Command.txt"
REN = "countries/Rendili.txt"
COR = "countries/Corellia.txt"
MAA = "countries/Manaan.txt"
BET = "countries/Bestine.txt"
MIM = "countries/Mimban.txt"
BYS = "countries/Byss.txt"
VON = "countries/Yuuzhan Vong.txt"
KOR = "countries/Korriban.txt"
FON = "countries/Fondor.txt"
FRE = "countries/Fresia.txt"
JAB = "countries/Jabiim.txt"
KYK = "countries/Kashyyyk.txt"
KUA = "countries/Kuat.txt"
KAL = "countries/Kalee.txt"
SSI = "countries/Ssi-ruuvi Imperium.txt"
MAN = "countries/Mandalore.txt"
CAL = "countries/Mon Calamari.txt"
NAB = "countries/Naboo.txt"
PAN = "countries/Pantora.txt"
RYL = "countries/Ryloth.txt"
SAL = "countries/Saleucami.txt"
SUL = "countries/Sullust.txt"
TAR = "countries/Taris.txt"
THY = "countries/Thyferra.txt"
CHS = "countries/Chiss Ascendancy.txt"
OND = "countries/Onderon.txt"
TRA = "countries/Trandosha.txt"
RHA = "countries/Sorcerers of Rhand.txt"
SER = "countries/Serreno.txt"
AUT = "countries/Corporate Sector Authority.txt"
COM = "countries/COMPNOR.txt"
EOH = "countries/Empire of the Hand.txt"
ICO = "countries/Imperial Oversector.txt"
DEL = "countries/Dellsos Federation.txt"
REE = "countries/Restored Empire.txt"
ZSJ = "countries/Zsinj's Empire.txt"
WAY = "countries/Wayland.txt"
TUN = "countries/Sorcerers of Tund.txt"
ROD = "countries/Rodia.txt"
HUT = "countries/Hutt Grand Council.txt"
CAT = "countries/Catonica.txt"
PEN = "countries/Pentastar Alignment.txt"
PRO = "countries/Mandalorian Protectors.txt"
AWA = "countries/Clan Awaud.txt"
SUN = "countries/ Sun Guard.txt"
ELD = "countries/Clan Eldar.txt"
ROK = "countries/Clan Rook.txt"
KRY = "countries/Clan Kryze.txt"